"filename", "language", "C++", "comment", "blank", "total"
"d:\Desktop\Project\SmartRoute\src\graph\graph.h", "C++", 62, 5, 25, 92
"d:\Desktop\Project\SmartRoute\src\graph\graph.hpp", "C++", 412, 162, 109, 683
"d:\Desktop\Project\SmartRoute\src\main.cpp", "C++", 12, 1, 6, 19
"d:\Desktop\Project\SmartRoute\src\main\main.h", "C++", 5, 0, 3, 8
"d:\Desktop\Project\SmartRoute\src\main\main.hpp", "C++", 12, 0, 9, 21
"d:\Desktop\Project\SmartRoute\src\module\module.h", "C++", 88, 7, 28, 123
"d:\Desktop\Project\SmartRoute\src\module\module.hpp", "C++", 41, 0, 14, 55
"d:\Desktop\Project\SmartRoute\src\server\server.h", "C++", 44, 0, 15, 59
"d:\Desktop\Project\SmartRoute\src\server\server.hpp", "C++", 257, 49, 84, 390
"d:\Desktop\Project\SmartRoute\src\system\system.h", "C++", 33, 3, 10, 46
"d:\Desktop\Project\SmartRoute\src\system\system.hpp", "C++", 192, 21, 63, 276
"d:\Desktop\Project\SmartRoute\src\utils\jsonTool.hpp", "C++", 31, 0, 8, 39
"d:\Desktop\Project\SmartRoute\src\utils\yamlTool.hpp", "C++", 31, 2, 14, 47
"Total", "-", 1220, 250, 388, 1858